.........................
.........................
..######....##...######..
..#*........#........*#..
..#.........#*........#..
..#.........####......#..
..#...................#..
..#...###.............#..
.......#~................
..#......................
..#......................
..##.##.....###.......#..
.....*#.....###.....###..
..*#........#####....~#..
..##.....................
...............###.......
.........#.....#*.....#..
..#......###...#......#..
..#......#~...........#..
..#......#............#..
..#...................#..
..#*.........*.......*#..
..######...####..######..
.........................
.........................
