.........................
.........................
..TSSSSS...SST...SSSSST..
..T..........T........T..
..T..........SSS......T..
..T....T..............T..
..T....T..............T..
..S..SSS...........T..S..
..................SSS....
..........SSSSS..........
.........................
..........T...T..........
..T.......T...SST........
..SSSS....T.....T...TSS..
..........T....FT...T....
..........SSSSSSS...T....
.........................
..T...................T..
..T.......SSTSS.......T..
..T.........T.........T..
..T.........T.........T..
..T.........T.........T..
..SSSSSS....S....SSSSSS..
.........................
.........................