.........................
.........................
..######...###...######..
..#..........#........#..
..#..........###......#..
..#....#..............#..
..#....#..............#..
..#..###...........#W.#..
..................###....
..........#####..........
.........................
..........#...#..........
..#.......#...###........
..####....#.....#...###..
..........#....F#...#....
..........#######...#....
.........................
..#...................#..
..#........####.......#..
..#.........#.........#..
..#.........#.........#..
..#.........#.........#..
..######....#....######..
.........................
.........................
